....................
.......#.....#......
..#.#....#.#.#...##.
#.....#.............
....#.......#.......
....#...............
#...##.##..........#
........#....#.#....
.#........##..#.#.##
....#...#..#......#.
#.#..#..#......#....
.....##....###..#...
.##..#.#...#..#..#.#
.....#..#......#...#
.....##..#.........#
..#........#...#....
..###........#.#.#..
..........#..#...#..
.....#.......#......
......#......#.#..#.
