....#....#............#.#...#.....#.....
.....#....#..........#....#...#..#....#.
#.#...##....#.........#.........##......
..##..........#.##......#.......##.#...#
......#.....#..##...#............#..##..
.##.#..........#.......#................
...#...#..##.......#....................
.......#..##...#....#........##........#
..#....#......#............##.........#.
............##.........#.#.#....#....#..
....#........#..........................
....#.#.#.##......#.#.##....#.#...##....
...#....#......#.#..........###.........
......####..##.....#...#..#....#........
#....#.........#............#.....####..
...##..##...#.........#............#....
...#.#.##.#....#......#...........##..#.
##.......................#......#.......
....##.#........#....#..#.#.............
.###..#..##......#.......#.....#.#.#....
.#....##.......#...........#......#..##.
##.........#.........###.....#...#......
##...#............#..#..#..##...#....#..
....#...#...#...............#.#.....#.#.
.................##.....#..#...#.##.#...
.#..#...###.#............#...#...#......
..#...##...........#..............#.....
...........#....#..#..#....#.##.....##..
....#.....#...##................##.#.#..
....#.............##.......#.......#....
.##.......#.#.#............#............
....#......#..........#.......#.#..#....
#..........#...#......##..##.......#.#..
.............#.##.........#.#....#.....#
..#........#...#.##...#..............##.
..........................##..#.........
...........##..#.....................###
..#..#..#...............#.#..#.....#.#..
........#......#..#.##...#.#...#.#.#.#..
...###..#...#....##..#........#...##....
